-1,-1,-1,-1,-1,-1,-1,-1,-1,-1,-1,-1,-1,-1,-1,-1,-1,-1,-1,-1,-1,-1,-1,-1,-1,-1,-1,-1,-1,-1,-1,-1,-1,-1,-1,-1,-1,11,12,12,12,12,12,13,-1,-1,-1,-1,-1,-1,-1,-1,-1,-1,-1,-1,-1,-1,-1,-1,-1,-1,-1,-1,-1,-1,-1,-1,-1,-1,-1,-1,-1,8,-1,-1,-1,-1,-1,-1,-1,-1,-1,-1,-1,-1,-1,-1,-1,-1,-1,-1,-1,-1,-1,-1,-1,-1,-1,-1,-1,-1,-1,-1,-1,-1,-1,-1,-1,-1,-1,-1,-1,-1,-1,-1,-1,-1,-1,-1,-1,-1,-1,-1,-1,-1,-1,-1,-1,-1,-1,-1,-1,-1,-1,-1,-1,-1,-1,-1,-1,-1,-1,-1,-1,-1,-1,-1,-1,14
-1,-1,-1,-1,-1,-1,-1,-1,-1,-1,-1,-1,-1,-1,-1,-1,-1,-1,-1,-1,-1,-1,-1,-1,-1,-1,-1,-1,-1,-1,-1,-1,-1,-1,-1,-1,-1,-1,-1,-1,-1,-1,-1,18,-1,-1,-1,-1,-1,-1,-1,-1,-1,-1,-1,-1,-1,-1,-1,-1,-1,-1,-1,-1,-1,-1,-1,-1,-1,-1,-1,-1,-1,10,8,8,8,-1,-1,-1,-1,-1,-1,-1,-1,-1,-1,-1,-1,-1,-1,-1,-1,-1,-1,-1,8,8,8,-1,-1,-1,-1,-1,-1,-1,-1,-1,-1,-1,-1,-1,-1,-1,-1,-1,-1,-1,-1,-1,-1,-1,-1,-1,-1,-1,-1,-1,-1,-1,-1,-1,-1,-1,-1,-1,-1,-1,-1,-1,-1,-1,-1,-1,10,-1,-1,-1,-1,-1
-1,-1,-1,-1,-1,-1,-1,-1,-1,-1,-1,-1,-1,-1,-1,-1,-1,-1,-1,-1,-1,-1,11,12,12,12,12,12,13,-1,-1,-1,-1,-1,-1,-1,-1,-1,-1,11,13,-1,-1,18,-1,-1,-1,-1,-1,-1,-1,-1,-1,-1,-1,-1,-1,-1,11,12,12,12,12,12,12,12,12,12,12,12,12,12,12,12,12,12,13,-1,-1,-1,-1,-1,-1,-1,-1,14,-1,-1,14,-1,-1,-1,-1,8,8,8,10,10,10,-1,-1,-1,-1,-1,-1,-1,-1,-1,-1,-1,-1,-1,-1,-1,-1,-1,-1,-1,-1,-1,-1,-1,-1,-1,-1,-1,-1,-1,-1,-1,-1,-1,-1,-1,-1,-1,-1,-1,-1,-1,-1,-1,-1,-1,10,-1,-1,-1,-1,14
-1,-1,-1,-1,-1,-1,-1,-1,-1,-1,-1,-1,-1,-1,-1,-1,-1,-1,-1,14,-1,-1,-1,-1,-1,-1,-1,-1,-1,-1,-1,-1,-1,-1,-1,-1,-1,-1,-1,-1,10,-1,-1,18,-1,-1,-1,-1,-1,-1,-1,-1,-1,-1,-1,-1,-1,-1,-1,-1,-1,-1,-1,-1,-1,-1,-1,-1,-1,-1,-1,-1,-1,-1,-1,-1,-1,-1,-1,-1,-1,-1,-1,-1,-1,-1,-1,-1,-1,-1,-1,-1,-1,10,10,10,10,11,13,-1,-1,-1,-1,-1,-1,-1,-1,8,-1,8,8,8,-1,-1,-1,-1,-1,-1,-1,-1,-1,11,12,12,12,12,13,-1,-1,-1,-1,-1,-1,-1,-1,-1,-1,-1,-1,-1,-1,-1,-1,-1,10,-1,-1,-1,-1,-1
13,-1,-1,-1,-1,-1,-1,-1,-1,-1,-1,-1,-1,-1,-1,-1,-1,-1,-1,-1,-1,-1,-1,-1,-1,-1,-1,-1,-1,-1,-1,-1,-1,-1,-1,-1,-1,11,13,-1,10,-1,11,18,-1,-1,-1,-1,-1,-1,-1,14,-1,-1,-1,-1,-1,-1,8,-1,-1,1,-1,-1,4,-1,-1,-1,5,-1,-1,-1,6,-1,-1,-1,-1,-1,-1,-1,-1,-1,11,13,-1,-1,-1,8,8,8,8,-1,-1,10,11,12,12,18,-1,-1,-1,-1,-1,-1,-1,-1,-1,10,-1,10,10,10,-1,-1,-1,-1,-1,-1,-1,-1,-1,-1,-1,-1,-1,-1,18,-1,-1,-1,-1,-1,-1,-1,-1,-1,-1,-1,-1,-1,-1,-1,-1,-1,10,-1,-1,-1,14,-1
18,-1,-1,-1,-1,-1,-1,-1,-1,-1,-1,-1,-1,-1,-1,-1,-1,-1,-1,-1,-1,-1,-1,-1,-1,-1,-1,-1,-1,-1,-1,-1,-1,-1,-1,-1,-1,10,-1,-1,10,-1,-1,18,-1,-1,-1,-1,-1,-1,-1,-1,-1,-1,-1,-1,-1,-1,11,12,12,12,12,12,12,12,12,12,12,12,12,12,12,12,12,12,13,-1,-1,-1,-1,-1,-1,-1,-1,-1,-1,14,10,10,14,-1,-1,10,-1,-1,-1,-1,-1,-1,-1,-1,-1,-1,-1,10,-1,-1,-1,-1,10,-1,-1,-1,-1,-1,-1,11,12,12,-1,-1,-1,-1,-1,-1,18,-1,-1,-1,-1,-1,-1,-1,-1,-1,-1,-1,-1,-1,-1,-1,-1,-1,10,-1,14,-1,-1,-1
18,13,-1,-1,-1,-1,-1,-1,-1,-1,-1,-1,-1,-1,-1,-1,-1,-1,-1,-1,-1,-1,-1,-1,-1,-1,-1,-1,-1,-1,-1,-1,-1,-1,-1,-1,-1,10,-1,11,10,13,-1,18,-1,-1,-1,-1,-1,14,-1,-1,-1,-1,-1,-1,-1,-1,-1,-1,-1,10,-1,-1,-1,10,-1,-1,-1,10,-1,-1,-1,10,-1,-1,-1,10,-1,-1,-1,14,-1,-1,-1,-1,-1,18,-1,-1,18,-1,-1,10,-1,-1,-1,-1,-1,-1,-1,-1,11,12,12,12,-1,-1,14,-1,-1,-1,-1,-1,-1,-1,-1,18,-1,-1,13,-1,-1,-1,-1,14,-1,-1,-1,-1,-1,-1,-1,11,12,12,12,12,-1,-1,-1,-1,-1,-1,10,-1,-1,-1,-1,14
18,18,-1,-1,-1,-1,-1,-1,-1,-1,-1,-1,-1,11,12,12,13,-1,-1,-1,-1,-1,-1,-1,-1,-1,-1,-1,-1,-1,-1,-1,-1,-1,-1,-1,-1,10,-1,-1,10,-1,-1,18,-1,-1,-1,-1,-1,-1,-1,-1,-1,-1,-1,-1,-1,-1,-1,-1,-1,-1,-1,-1,-1,-1,-1,-1,-1,-1,-1,-1,-1,-1,-1,-1,-1,-1,-1,-1,-1,-1,-1,-1,-1,-1,-1,18,-1,-1,18,-1,-1,-1,14,-1,-1,-1,11,12,12,12,18,18,18,18,-1,-1,-1,14,-1,-1,-1,-1,-1,-1,-1,18,-1,-1,18,12,13,-1,-1,18,-1,-1,-1,-1,-1,-1,11,-1,-1,-1,-1,-1,-1,-1,-1,-1,8,-1,10,-1,-1,-1,-1,-1
18,18,-1,-1,11,13,-1,-1,-1,-1,-1,-1,14,-1,-1,-1,-1,-1,-1,-1,-1,-1,-1,-1,-1,-1,-1,-1,-1,-1,-1,-1,-1,-1,-1,-1,-1,10,13,-1,10,-1,11,18,-1,-1,-1,14,-1,-1,-1,-1,-1,-1,-1,14,-1,-1,-1,10,-1,-1,-1,10,-1,-1,-1,10,-1,-1,-1,10,-1,-1,-1,10,-1,-1,-1,14,-1,-1,-1,-1,-1,-1,-1,18,-1,-1,18,-1,-1,-1,-1,-1,-1,-1,18,18,18,18,18,18,18,18,-1,-1,-1,-1,-1,-1,-1,-1,8,-1,-1,18,-1,-1,-1,-1,18,13,-1,18,-1,-1,-1,11,12,12,-1,-1,-1,-1,-1,-1,-1,-1,11,12,13,-1,10,-1,-1,-1,-1,14
18,18,-1,-1,-1,-1,-1,11,12,12,12,13,-1,-1,-1,-1,-1,-1,-1,-1,-1,-1,-1,-1,-1,-1,14,-1,-1,-1,-1,-1,-1,-1,-1,-1,-1,10,-1,-1,10,-1,-1,18,-1,-1,-1,-1,-1,-1,-1,-1,-1,-1,-1,-1,-1,-1,11,12,12,12,12,12,12,12,12,12,12,12,12,12,12,12,12,12,13,-1,-1,-1,-1,-1,-1,-1,-1,-1,-1,18,-1,-1,18,-1,-1,-1,-1,-1,11,13,18,18,18,18,18,18,18,18,-1,-1,-1,-1,-1,-1,-1,-1,11,12,12,18,-1,-1,-1,-1,18,-1,-1,18,-1,-1,-1,-1,-1,-1,-1,-1,-1,-1,-1,-1,-1,8,-1,-1,-1,-1,10,-1,-1,14,-1,-1
18,18,13,-1,-1,-1,-1,-1,-1,-1,-1,-1,-1,-1,-1,-1,-1,-1,-1,-1,-1,-1,-1,-1,-1,-1,18,-1,-1,-1,-1,-1,-1,-1,-1,-1,-1,-1,-1,11,12,13,-1,-1,-1,-1,14,-1,-1,-1,-1,-1,-1,-1,14,-1,-1,-1,-1,-1,-1,-1,-1,-1,-1,-1,-1,-1,-1,-1,-1,-1,-1,-1,-1,-1,-1,-1,-1,-1,-1,11,-1,-1,-1,-1,-1,18,-1,10,-1,-1,-1,-1,-1,-1,-1,-1,18,18,18,18,18,18,18,18,-1,-1,-1,-1,-1,-1,8,-1,18,-1,-1,-1,-1,-1,-1,-1,18,13,-1,-1,-1,-1,-1,-1,-1,-1,-1,-1,-1,-1,-1,-1,8,10,-1,-1,-1,-1,10,-1,-1,-1,-1,-1
18,18,18,3,-1,-1,-1,-1,-1,-1,-1,-1,-1,-1,-1,-1,-1,-1,-1,-1,-1,-1,11,13,-1,-1,18,13,-1,-1,-1,-1,-1,-1,-1,-1,-1,-1,-1,18,18,-1,-1,-1,-1,-1,-1,-1,-1,-1,-1,-1,-1,-1,-1,-1,-1,-1,-1,-1,-1,-1,-1,-1,-1,-1,-1,-1,-1,-1,-1,-1,-1,-1,-1,-1,-1,-1,-1,-1,11,-1,-1,-1,-1,-1,11,18,12,-1,-1,-1,-1,-1,-1,11,12,13,18,18,18,18,18,18,18,18,-1,-1,-1,-1,-1,-1,14,8,-1,-1,-1,-1,-1,-1,11,-1,-1,-1,-1,8,-1,-1,-1,-1,-1,-1,-1,-1,-1,-1,-1,-1,10,-1,-1,-1,-1,11,12,-1,-1,-1,-1,-1
18,18,18,13,-1,-1,-1,-1,-1,-1,-1,-1,-1,-1,-1,-1,-1,-1,11,12,12,12,18,18,12,12,18,18,13,-1,-1,-1,-1,11,12,12,12,12,12,18,18,12,12,12,12,-1,-1,-1,-1,-1,-1,-1,-1,-1,-1,-1,-1,-1,-1,8,-1,8,-1,8,-1,8,-1,-1,8,-1,-1,8,-1,8,-1,-1,-1,-1,-1,11,-1,-1,-1,-1,-1,-1,18,-1,-1,14,-1,-1,14,-1,-1,-1,-1,-1,18,18,18,18,18,18,18,18,-1,-1,-1,-1,-1,-1,18,13,-1,-1,-1,-1,-1,11,10,-1,-1,-1,14,10,8,-1,-1,-1,-1,-1,-1,-1,-1,-1,-1,-1,-1,-1,-1,-1,-1,-1,18,-1,-1,-1,-1,14
18,18,18,18,13,-1,-1,-1,-1,-1,-1,-1,-1,-1,-1,-1,-1,-1,18,18,18,18,18,18,18,18,18,18,18,-1,-1,-1,-1,18,18,18,18,18,18,18,18,18,18,18,18,-1,-1,-1,-1,-1,-1,-1,-1,-1,-1,-1,-1,-1,11,12,12,12,12,12,12,12,12,12,12,12,12,12,12,12,12,12,13,-1,11,18,-1,-1,-1,-1,-1,12,18,-1,-1,18,8,-1,-1,-1,-1,8,8,8,18,18,18,18,18,18,18,18,-1,-1,-1,-1,-1,-1,-1,-1,-1,-1,8,14,-1,-1,-1,-1,-1,-1,-1,10,-1,14,-1,11,12,12,12,12,12,12,12,12,-1,-1,-1,-1,7,-1,-1,-1,-1,-1,-1,-1
18,18,18,18,18,13,-1,-1,11,12,13,-1,-1,-1,-1,-1,-1,-1,18,18,18,18,18,18,18,18,18,18,18,8,8,8,8,18,18,18,18,18,18,18,18,18,18,18,18,-1,-1,12,12,12,12,12,12,-1,-1,-1,-1,-1,-1,-1,-1,-1,-1,-1,-1,-1,-1,-1,-1,-1,-1,-1,-1,-1,-1,-1,-1,-1,-1,18,12,12,12,13,12,18,-1,10,-1,18,10,8,8,8,8,11,12,12,18,18,18,18,18,18,18,18,-1,14,-1,14,-1,11,12,12,13,8,10,-1,-1,-1,11,12,12,12,12,13,-1,-1,-1,-1,-1,-1,-1,-1,-1,-1,-1,-1,-1,11,12,12,12,12,12,12,12,13,-1,-1
8,8,8,8,8,8,8,8,8,8,8,8,8,8,8,8,8,8,8,8,8,8,8,8,8,8,8,8,8,8,8,8,8,8,8,8,8,8,8,8,8,8,8,8,8,8,8,8,8,8,8,8,8,8,8,8,8,8,8,8,8,8,8,8,8,8,8,8,8,8,8,8,8,8,8,8,8,8,8,8,8,8,8,8,8,8,8,8,8,8,8,8,8,8,8,8,8,8,8,8,8,8,8,8,8,8,8,8,8,8,8,8,8,8,8,8,8,8,8,8,8,8,8,8,8,8,8,8,8,8,8,8,8,8,8,8,8,8,8,8,8,8,8,8,8,8,8,8,8,8
